10 10
1.0 1.0

35 55 75 94 112 35 48 66 86 110 
47 61 80 104 134 55 63 67 64 56 
57 57 69 92 126 66 81 81 66 37 
66 45 42 57 89 68 100 108 92 53 
73 25 0 0 22 62 122 149 143 104 
35 41 52 69 91 35 52 64 70 71 
49 64 79 93 108 48 64 81 99 118 
61 90 113 130 140 64 74 92 116 147 
74 120 155 178 189 84 83 95 121 160 
85 154 205 238 255 107 90 92 114 156 
