25 25
1.0 1.0
94 96 102 111 122 94 103 109 112 111 94 101 110 119 129 94 104 112 120 126 94 91 89 86 84
97 104 116 132 153 104 106 107 107 107 104 104 101 93 82 94 107 120 133 147 98 95 93 91 89
101 112 129 152 180 113 105 98 94 91 110 110 101 83 57 98 108 121 135 151 100 98 96 93 91
106 120 141 169 204 123 101 84 71 63 113 119 110 88 53 104 108 115 126 140 100 98 96 94 92
112 127 151 184 225 132 94 63 39 23 114 131 129 109 71 114 106 103 105 113 99 97 95 94 92
94 95 100 109 123 94 96 97 98 98 94 104 110 112 110 94 103 113 122 133 94 92 89 87 85
102 107 113 120 127 103 105 109 115 123 104 106 105 100 90 97 108 120 134 150 101 100 98 97 95
107 121 131 138 141 112 114 121 131 145 113 108 98 84 65 99 111 126 143 163 107 106 105 104 103
111 135 152 162 165 122 123 131 145 166 123 107 87 63 35 99 112 128 149 173 111 111 110 110 110
111 149 176 193 198 132 132 141 158 185 133 106 75 39 0 98 111 129 152 179 113 113 114 114 115
94 99 104 110 116 94 95 98 103 110 94 103 109 110 108 94 100 108 118 129 94 92 91 89 87
98 105 110 115 119 95 107 122 140 161 103 108 111 113 112 101 106 114 124 137 103 103 102 101 100
105 114 122 128 133 99 119 143 171 203 112 111 110 109 109 105 111 120 132 147 112 112 112 112 113
113 128 141 151 158 108 131 160 194 234 122 112 104 99 97 108 115 126 140 158 119 120 122 123 124
122 146 166 181 193 121 144 174 211 255 132 111 95 83 78 110 118 131 149 171 126 128 130 132 134
94 104 113 122 130 94 98 105 115 127 94 101 107 111 113 94 97 102 109 119 94 93 92 92 91
97 106 118 133 152 104 107 110 111 111 103 108 112 114 115 100 108 116 123 131 100 98 96 94 92
101 103 113 130 155 109 117 120 117 108 111 115 117 117 117 106 120 132 142 149 108 105 102 98 95
106 96 99 113 138 110 127 135 132 120 120 122 122 121 119 113 135 152 165 173 117 113 109 104 100
111 85 75 80 102 106 137 154 157 146 130 129 127 125 121 120 151 175 192 203 128 123 117 112 106
94 96 102 111 124 94 99 102 104 105 94 102 108 113 116 94 102 109 117 125 94 92 90 88 86
93 94 98 106 117 91 97 100 103 104 92 100 107 112 116 92 100 108 116 123 92 90 88 87 85
92 91 94 100 110 89 94 98 101 102 90 99 106 112 117 91 99 106 114 122 91 89 87 85 83
91 89 90 94 103 87 92 96 99 101 87 97 105 112 117 89 97 105 112 120 89 87 85 83 82
91 86 86 89 95 84 90 95 98 100 85 95 104 111 117 88 95 103 111 119 88 86 84 82 80